
#################################################
#                                               #
#       #                                       #
#                                               #
#       @                                       #
#                                               #
#       T                                       #
#                                               #
#                                               #
#                                               #
#                                               #
#                                               #
#                                               #
#################################################
