#######################################################################################
#...............#.............................................#.......................#
#...............#........................#.################...#.##....................#
#...............#........................#.#..................#.##....................#
#.........@.....#........................#........#######.#.#.#.##....................#
#..............o#........................########.#.....#.#.#...##....................#
#...............#........................#..............#.#.######....................#
########.#########################.......#..#....##...#.#.#.#....#....................#
#...........#####................#......##..#.#.#####.###.####...####################.#
#...........#####..@...........o.#......#...#.#.......#...............................#
#...........#####................#......#.###.######.###.############################.#
#.....@.................................#...........#...#......................#......#
#...........#####................#......##.##.#####.##.###.......................######
#...........######################.........##....#....###......................#......#
##.#######################################....#######################################.#
#...#..................#..#..........#...######.####.....###...................#......#
#...#..................#.##..........#.......##..........###.......................####
#...#.#...@............#.............#...........###.....###..........................#
#...#.#................#.............#.......##.####.....###..........................#
#...#.#................#.............#.......##.####.....###..........................#
#...#.#................#.............#.......##.####.....###...........###............#
#...#.#................#.....................##.####.....###..........#####...........#
#...#.#................#.............###################.###.........###.###..........#
#.....#................#.............#.....................#.........##...###.........#
#...###................#.............#.....................#...............##.........#
#...#.#................#.............#.....................#..............###.........#
#...#.#................#.............#....................##............####..........#
#...#.################.#.............#.................#..##............##............#
#...#.....#..........#...#############.#########.......#..##..........................#
#...#.#...#...######.#####...........#.........#.......#..##............##............#
#...#.#...#...#.......####...........#.........#.......#..##............##............#
#...#.#.......#.......####...........#.........#.......#..##..........................#
#.o.#.#...#...#.......####...........#.........#.......#..##..........................#
#####.#.......#.......####...........#.........#.......#..##..........................#
#.....#...#...#.......####...........#.#########.......#..##..........................#
#...#.#...#...#........................#...............#..##..........................#
#...#.#.......#......................####.......########..##..........................#
#######################################################################################
